111111111
1000P0101
1C0000111
1E0000001
111111111
