11111111
1P000C01
11101111
100001E1
11111111
