1111111111
1EC00000C1
1100000011
1C00CP0001
1111111111