111111111111111
10C00000000C001
100110000011001
111110001111101
11111100011C001
1ECP0001111C001
111111111111111