111111111111111
10C000E0000C001
1P1111C11111101
100000000000001
111111101111111
1C0C0C0C0C0C0C1
111111111111111
