1111111111
1E000C0001
1111110C01
1C000P0001
1111111111