111111
100E01
1C0111
1P01C1
111111
