111111
100001
1C01C1
1PE101
111111
