1111111111
1P1C10C001
1010111101
1000100C01
1110101111
1C0000C0E1
1111111111
