1111111
1P000C1
1000101
1C00PE1
1111111
