11111111
1P0001C1
11101111
1C0000E1
11111111
