111111
1P0C1
100001
1C0E01
111111
