111111
100C01
100001
1C0E01
111111
